
sudo dnf install @base-x                Installs the core X server packages and dependencies.
sudo dnf install @xfce-desktop	        Installs the full Xfce desktop environment group.


sudo systemctl enable xdm.service	                    Enables the XDM login manager to start at boot
sudo systemctl set-default graphical.target	            Switches the default boot mode from text (multi-user) to GUI (graphical).
sudo reboot	                                      Applies the changes and starts the server into the new graphical login screen (XDM).


sudo systemctl isolate graphical.target	            Temporarily switches to GUI mode.

sudo dnf update	            Ensures latest software updates and security patches.
sudo passwd root	        Set a strong password for the most powerful user.
sudo useradd -m username	Create a new user for daily tasks
sudo passwd username	     Set a password for the new user.
sudo dnf install httpd	     Example command to install additional software packages.


nmcli connection show or ip addr show	  Commands to view current network interfaces.
sudo nano /etc/sysconfig/network-scripts/ifcfg-eth0	          Use text editor to set parameters like 
sudo systemctl restart NetworkManager	       Restarts the service to apply changes.


sudo systemctl enable firewalld	           Configures the firewall to start on boot
sudo firewall-cmd --permanent --zone=public --add-service=ssh      Permanently allows SSH traffic.
sudo firewall-cmd --reload	            Makes the changes active 


sudo dnf install nano	                Installs the easy-to-use editor.
sudo nano /etc/dhcp/dhcpd.conf          Opens the configuration file.


sudo dnf install dhcp-server	        Installs the DHCP server daemon.
sudo systemctl enable dhcpd             Configures service to start at boot.



